{ 
  "Layers": [
    {
      "Map": [
        0, 0, 0, 0, 0, 0, 0, 0, 0, 0, 0, 0, 0,
        0, 0, 0, 0, 0, 0, 0, 0, 0, 0, 0, 0, 0,
        0, 0, 1, 0, 1, 0, 1, 1, 1, 0, 1, 0, 0,
        0, 0, 1, 0, 1, 0, 0, 1, 0, 0, 1, 0, 0,
        0, 0, 1, 1, 1, 0, 0, 1, 0, 0, 1, 0, 0,
        0, 0, 1, 0, 1, 0, 0, 1, 0, 0, 0, 0, 0,
        0, 0, 1, 0, 1, 0, 1, 1, 1, 0, 1, 0, 0,
        0, 0, 0, 0, 0, 0, 0, 0, 0, 0, 0, 0, 0,
        0, 0, 0, 1, 1, 1, 1, 1, 1, 1, 1, 1, 1,
        1, 1, 1, 1, 1, 1, 1, 1, 1, 1, 1, 1, 1,
        1, 1, 1, 1, 1, 1, 1, 1, 1, 1, 1, 1, 1,
        1, 1, 1, 1, 1, 1, 1, 1, 1, 1, 1, 1, 1
      ],
      "Tileset": "Sand-Md-Rough",
      "Color": "#e9bb16",
      "CanWalk": true,
      "Carveout": false
    },
    {
      "Map": [
        0, 0, 0, 0, 0, 0, 0, 0, 0, 0, 0, 0, 0,
        0, 0, 0, 0, 0, 0, 0, 0, 0, 0, 0, 0, 0,
        0, 0, 0, 0, 0, 0, 0, 0, 0, 0, 0, 0, 0,
        0, 0, 0, 0, 0, 0, 0, 0, 0, 0, 0, 0, 0,
        0, 0, 0, 0, 0, 0, 0, 0, 0, 0, 0, 0, 0,
        0, 0, 0, 0, 0, 0, 0, 0, 0, 0, 0, 0, 0,
        0, 0, 0, 0, 0, 0, 0, 0, 0, 0, 0, 0, 0,
        0, 0, 0, 0, 0, 0, 0, 0, 0, 0, 0, 0, 0,
        0, 0, 0, 0, 0, 0, 0, 0, 0, 0, 0, 0, 0,
        0, 0, 0, 0, 0, 0, 0, 0, 0, 0, 1, 1, 1,
        0, 0, 1, 1, 1, 1, 1, 1, 1, 1, 1, 1, 1,
        0, 0, 1, 1, 1, 1, 0, 1, 1, 1, 1, 1, 1
      ],
      "Tileset": "Grass-Md-Rough",
      "Color": "#24a326",
      "CanWalk": true,
      "Carveout": false
    }
  ],
  "MapDataSize": {
    "x":13,
    "y":12
  },
  "Start":  {
    "x":6,
    "y":6
  }
}